10 10 15 30
0 0 0 0 -1 -1 0 0 0 0
0  S 0 0 0 0 0 -1 0 -1
0 0 -1 -1 -1 0 0 -1 0 -1
0 0 0 0 -1 0 0 -1 0 0
0 0 -1 -1 -1 0 0 -1 -1 0
1 0 -1 0 0 F 0 0 -1 0
0 0 F 0 -1 4 -1 8 -1 0
0 0 0 0 -1 0 0 0 G 0
0 -1 -1 -1 -1 0 0 0 0 0
0 0 5 0 0 0 -1 -1 -1 0
